11111111111111111
100000000000111E1
10000000000000001
100000000P0000001
100000C0000000001
11111111111111111