11111111111111111
1000000000CC111E1
10000000000000001
100000000P0000001
1CCCCCCCCC0000001
11111111111111111