111111111111111111111
1C0000000000P00000001
110000000100000000001
1000001100CCC00000001
100000000000011100011
100000000001000001E11
111111111111111111111