111111111111111111111111111111
100000110001100000001000000001
100111000000PCE000000000000001
100000001001000001001000000001
100000000000100000001000000001
100000000000100000001000000001
111111111111111111111111111111