1111111111111111111111111111111111111111111111111111111111
1000001100011000000010000000000000000000000000000010000011
100111000000PCE0000000000000000000000000000000000010000011
1000000010010000010010000000000000000000000000000000010001
1000000000001000000010000000000000000000000000000000010001
1000000000001000000010000000000000000000000000000000010001
1000000000001000000010000000000000000000000000000000010001
1111111111111111111111111111111111111111111111111111111111