111111111111111111111
1C0111000000P00000001
10000010010000000C001
1000001100C1100000001
100000001000011100001
100000001001000001E01
100000000000100000001
111111111111111111111